11111111111111111111111111
100C0000000000000000C00001
10000010000000000000000001
1000001C000000000000000001
10E00011100000000000000001
10000010000000000000C00001
10000000000C00000000000001
10P00000000000000000000001
1000000000000000C000000001
10000000000000000000000001
10000000000000001110000001
10000000000000001C00000001
11011111111111111111111111